000000000000000000000000000000000000000000000000000000000000000000000000000000
011111111110111111111101111111111011111111110111111111101111111111011111111110
023333333320233333333202333333332023333333320233333333202333333332023333333320
023333333320233333333202333333332023333333320233333333202333333332023333333320
023311113311133111133111331111331113311113311133111133111331111331113311113320
023320023333333200233333332002333333320023333333200233333332002333333320023320
023320023333333200233333332002333333320023333333200233333332002333333320023320
023311113311133111133111331111331113311113311133111133111331111331113311113320
023333333320233333333202333333332023333333320233333333202333333332023333333320
023333333320233333333202333333332023333333320233333333202333333332023333333320
011113311110111133111101111331111011113311110111133111101111331111011113311110
000023320000000233200000002332000000023320000000233200000002332000000023320000
011113311110111133111101111331111011113311110111133111101111331111011113311110
023333333320233333333202333333332023333333320233333333202333333332023333333320
023333333320233333333202333333332023333333320233333333202333333332023333333320
023311113311133111133111331111331113311113311133111133111331111331113311113320
023320023333333200233333332002333333320023333333200233333332002333333320023320
023320023333333200233333332002333333320023333333200233333332002333333320023320
023311113311133111133111331111331113311113311133111133111331111331113311113320
023333333320233333333202333333332023333333320233333333202333333332023333333320
023333333320233333333202333333332023333333320233333333202333333332023333333320
011113311110111133111101111331111011113311110111133111101111331111011113311110
000023320000000233200000002332000000023320000000233200000002332000000023320000
011113311110111133111101111331111011113311110111133111101111331111011113311110
023333333320233333333202333333332023333333320233333333202333333332023333333320
023333333320233333333202333333332023333333320233333333202333333332023333333320
023311113311133111133111331111331113311113311133111133111331111331113311113320
023320023333333200233333332002333333320023333333200233333332002333333320023320
023320023333333200233333332002333333320023333333200233333332002333333320023320
023311113311133111133111331111331113311113311133111133111331111331113311113320
023333333320233333333202333333332023333333320233333333202333333332023333333320
023333333320233333333202333333332023333333320233333333202333333332023333333320
011113311110111133111101111331111011113311110111133111101111331111011113311110
000023320000000233200000002332000000023320000000233200000002332000000023320000
011113311110111133111101111331111011113311110111133111101111331111011113311110
023333333320233333333202333333332023333333320233333333202333333332023333333320
023333333320233333333202333333332023333333320233333333202333333332023333333320
023311113311133111133111331111331113311113311133111133111331111331113311113320
023320023333333200233333332002333333320023333333200233333332002333333320023320
023320023333333200233333332002333333320023333333200233333332002333333320023320
023311113311133111133111331111331113311113311133111133111331111331113311113320
023333333320233333333202333333332023333333320233333333202333333332023333333320
023333333320233333333202333333332023333333320233333333202333333332023333333320
011111111110111111111101111111111011111111110111111111101111111111011111111110
000000000000000000000000000000000000000000000000000000000000000000000000000000