0000000000
1111111111
2333333332
2333111332
2333202332
2333202332
2333111332
2333333332
1111111111
0000000000