00000000000000000000000000000000000000000000000000000000000000000000000000000
01111111111011111111110111111111101111111111011111111110111111111101111111111
02333333332023333333320233333333202333333332023333333320233333333202333333332
02333333332023333333320233333333202333333332023333333320233333333202333333332
02331111331113311113311133111133111331111331113311113311133111133111331111331
02332002333333320023333333200233333332002333333320023333333200233333332002333
02332002333333320023333333200233333332002333333320023333333200233333332002333
02331111331113311113311133111133111331111331113311113311133111133111331111331
02333333332023333333320233333333202333333332023333333320233333333202333333332
02333333332023333333320233333333202333333332023333333320233333333202333333332
01111331111011113311110111133111101111331111011113311110111133111101111331111
00002332000000023320000000233200000002332000000023320000000233200000002332000
01111331111011113311110111133111101111331111011113311110111133111101111331111
02333333332023333333320233333333202333333332023333333320233333333202333333332
02333333332023333333320233333333202333333332023333333320233333333202333333332
02331111331113311113311133111133111331111331113311113311133111133111331111331
02332002333333320023333333200233333332002333333320023333333200233333332002333
02332002333333320023333333200233333332002333333320023333333200233333332002333
02331111331113311113311133111133111331111331113311113311133111133111331111331
02333333332023333333320233333333202333333332023333333320233333333202333333332
02333333332023333333320233333333202333333332023333333320233333333202333333332
01111331111011113311110111133111101111331111011113311110111133111101111331111
00002332000000023320000000233200000002332000000023320000000233200000002332000
01111331111011113311110111133111101111331111011113311110111133111101111331111
02333333332023333333320233333333202333333332023333333320233333333202333333332
02333333332023333333320233333333202333333332023333333320233333333202333333332
02331111331113311113311133111133111331111331113311113311133111133111331111331
02332002333333320023333333200233333332002333333320023333333200233333332002333
02332002333333320023333333200233333332002333333320023333333200233333332002333
02331111331113311113311133111133111331111331113311113311133111133111331111331
02333333332023333333320233333333202333333332023333333320233333333202333333332
02333333332023333333320233333333202333333332023333333320233333333202333333332
01111331111011113311110111133111101111331111011113311110111133111101111331111
00002332000000023320000000233200000002332000000023320000000233200000002332000
01111331111011113311110111133111101111331111011113311110111133111101111331111
02333333332023333333320233333333202333333332023333333320233333333202333333332
02333333332023333333320233333333202333333332023333333320233333333202333333332
02331111331113311113311133111133111331111331113311113311133111133111331111331
02332002333333320023333333200233333332002333333320023333333200233333332002333
02332002333333320023333333200233333332002333333320023333333200233333332002333
02331111331113311113311133111133111331111331113311113311133111133111331111331
02333333332023333333320233333333202333333332023333333320233333333202333333332
02333333332023333333320233333333202333333332023333333320233333333202333333332
01111331111011113311110111133111101111331111011113311110111133111101111331111
00002332000000023320000000233200000002332000000023320000000233200000002332000