000000000000000000000000000000
111111111111111111111111111111
233333333223333333322333333332
233311133113331113311333111332
233320233333332023333333202332
233320233333332023333333202332
233311133113331113311333111332
233333333223333333322333333332
111113111111111311111111131111
000023200000002320000000232000
000023200000002320000000232000
111113111111111311111111131111
233333333223333333322333333332
233311133113331113311333111332
233320233333332023333333202332
233320233333332023333333202332
233311133113331113311333111332
233333333223333333322333333332
111111111111111111111111111111
000000000000000000000000000000