000000000000000000000000000000000000000000000000000000000000
011111111111111111111111111111111111111111111111111111111110
023333333333333333333333333333333333333333333333333333333320
023333333333333333333333333333333333333333333333333333333320
023311113333111133331111333311113333111133331111333311113320
023320023333200233332002333320023333200233332002333320023320
023320023333200233332002333320023333200233332002333320023320
023311113333111133331111333311113333111133331111333311113320
023333333333333333333333333333333333333333333333333333333320
023333333333333333333333333333333333333333333333333333333320
023333333333333333333333333333333333333333333333333333333320
023333333333333333333333333333333333333333333333333333333320
023311113333111133331111333311113333111133331111333311113320
023320023333200233332002333320023333200233332002333320023320
023320023333200233332002333320023333200233332002333320023320
023311113333111133331111333311113333111133331111333311113320
023333333333333333333333333333333333333333333333333333333320
023333333333333333333333333333333333333333333333333333333320
023333333333333333333333333333333333333333333333333333333320
023333333333333333333333333333333333333333333333333333333320
023311113333111133331111333311113333111133331111333311113320
023320023333200233332002333320023333200233332002333320023320
023320023333200233332002333320023333200233332002333320023320
023311113333111133331111333311113333111133331111333311113320
023333333333333333333333333333333333333333333333333333333320
023333333333333333333333333333333333333333333333333333333320
023333333333333333333333333333333333333333333333333333333320
023333333333333333333333333333333333333333333333333333333320
023311113333111133331111333311113333111133331111333311113320
023320023333200233332002333320023333200233332002333320023320
023320023333200233332002333320023333200233332002333320023320
023311113333111133331111333311113333111133331111333311113320
023333333333333333333333333333333333333333333333333333333320
023333333333333333333333333333333333333333333333333333333320
011111111111111111111111111111111111111111111111111111111110
000000000000000000000000000000000000000000000000000000000000