0000000000
0000011111
1111113332
2333333332
2333331111
1111332332
2333331332
1111333332
0001111111
0000000000