00000000000000000000000000000000000000000000000000000000000000000000000000000000000000
01111111111111111111111111111111111111111111111111111111111111111111111111111111111110
02333333333333333333333333333333333333333333333333333333333333333333333333333333333320
02333333333333333333333333333333333333333333333333333333333333333333333333333333333320
02333333333333333333333333333333333333333333333333333333333333333333333333333333333320
02333333333333333333333333333333333333333333333333333333333333333333333333333333333320
02333333333333333333333333333333333333333333333333333333333333333333333333333333333320
02333333333333333333333333333333333333333333333333333333333333333333333333333333333320
02333333333333333333333333333333333333333333333333333333333333333333333333333333333320
02333333333333333333333333333333333333333333333333333333333333333333333333333333333320
02333333333333333333333333333333333333333333333333333333333333333333333333333333333320
02333333333333333333333333333333333333333333333333333333333333333333333333333333333320
02333333333333333333333333333333333333333333333333333333333333333333333333333333333320
02333333333333333333333333333333333333333333333333333333333333333333333333333333333320
02333333333333333333333333333333333333333333333333333333333333333333333333333333333320
02333333333333333333333333333333333333333333333333333333333333333333333333333333333320
02333333333333333333333333333333333333333333333333333333333333333333333333333333333320
02333333333333333333333333333333333333333333333333333333333333333333333333333333333320
02333333333333333333333333333333333333333333333333333333333333333333333333333333333320
02333333333333333333333333333333333333333333333333333333333333333333333333333333333320
02333333333333333333333333333333333333333333333333333333333333333333333333333333333320
02333333333333333333333333333333333333333333333333333333333333333333333333333333333320
02333333333333333333333333333333333333333333333333333333333333333333333333333333333320
02333333333333333333333333333333333333333333333333333333333333333333333333333333333320
02333333333333333333333333333333333333333333333333333333333333333333333333333333333320
02333333333333333333333333333333333333333333333333333333333333333333333333333333333320
02333333333333333333333333333333333333333333333333333333333333333333333333333333333320
02333333333333333333333333333333333333333333333333333333333333333333333333333333333320
02333333333333333333333333333333333333333333333333333333333333333333333333333333333320
02333333333333333333333333333333333333333333333333333333333333333333333333333333333320
02333333333333333333333333333333333333333333333333333333333333333333333333333333333320
02333333333333333333333333333333333333333333333333333333333333333333333333333333333320
02333333333333333333333333333333333333333333333333333333333333333333333333333333333320
02333333333333333333333333333333333333333333333333333333333333333333333333333333333320
02333333333333333333333333333333333333333333333333333333333333333333333333333333333320
02333333333333333333333333333333333333333333333333333333333333333333333333333333333320
02333333333333333333333333333333333333333333333333333333333333333333333333333333333320
01111111111111111111111111111111111111111111111111111111111111111111111111111111111110
00000000000000000000000000000000000000000000000000000000000000000000000000000000000000